[
----------------------------------------|
-        -     *********          *   *-|
-        -             *          *   *-|
-        -    --------                *-|
-        ------      -------***-----* *-|
------   -                          * *-|
-****    -                          * *-|
-        -           ---            * *-|
-        - --    --       --           -|
-**   *---                     --      -|
-        -***    **************-------*-|
-       *-   *  *      *  -            -|
-        -                -            -|
------  *-------          ---  -*--    -|
-****    -*     -   ---- *-*   -   **- -|
-*  *   *-    -- - -   * *-   --       -|
-*       -       * *   * *-  --- -     -|
------------     * *   *     **- *    --|
-***     -  *    * * - ---------  ---* -|
-* *     -   --    - *     *   *       -|
-* *  -* -        -   --     *  -      -|
-* * --* ---------    **--       *-    -|
-*   -   -*   *     - *  *--       -- *-|
------   -*D  * -  * **    *--   **** *-|
-***     -*--   -     *      ---      *-|
-     ----------------------------------|
-    *        - *       --             -|
-         -     *   --  -- --          -|
-       * - * -    *--*    --*  * -*   -|
----------------------------------------|
]






/
